1111111111111111
10000000000000011
1P0C0000000000E1
1111111111111111
