11111111011111
10000000C00001
1E000P00000001
11111111111111
