111111111
100 11111
1aPE11111
1C1111111
111111111
