111111111111
10000000E001
100000000001
100000000001
1000000P0001
111111111111
