11111111111111111
100000000C0000001
1000000P000000001
11111111111111111
