11111111111111
11000000000001
1010000E000001
10010000000001
10001000000001
100001000C0001
10000010000001
100P0001000001
10000000100001
11111111111111
