1111111111
10000C00C1
1000000001
1E00000001
1111111111
