1111111111111
1PE00001000C1
1000000111111
1111111111111
