11111111111111
10000P100000E1
1C00001000C001
11111111111111
