0000000000
0000000000
00P00000E0
00000C0000
0000000000
