111111111
1E00C00E1
100000001
1C000P001
111111111
