1111111111111
1000000P00001
1P00000000C01
100C0E0000C01
1111111111111
