111111111111111
100000000000001
1C0000000000001
110000000000001
11100000P0000E1
111111111111111
