111111111111111
1000000000000E1
101111111111111
1C1000C00000001
101011111111101
10100000000P101
101111111111101
10000000000C001
111111111111111
