1111111111111111111111111111111
1000000000000000000000000000001
1000000000000000000000000000001
10000000000000000000000C0000001
1000000000000000000011111000001
10000000000000000C0000000000001
1000000000000011111000000000001
1000000000000000000000000000001
1000000011111000000000000000001
10P0000000000000000000000000001
1111100000000000000000000000001
11111111000000000000C0000000001
111111111111110000111110000E001
1111111111111100001111111111111
1111111111111111111111111111111
